CCCCCCCCCCCCCCCCCCCC
C       C          C
C       L  S   K   C
C       C          C
CCCCCCCCCCCCCCCCCCCC
